111111111111111
1000P00C0000011
1E0000000C00001
111111111111111
sqlut
